1 37 4578 1161 5664 7849 3883 7885 1834 5645 6004 7995 6188 8030 8057 8084 4075 8168 8199 3117 6180 6638 8246 3919 6029 6540 4239 8429 5934 3962 2331 8543 6468 4734 3127 6381 5572 6224 1298 
1 35 4578 7749 6931 2362 7667 4708 6778 7597 6867 3067 4945 2851 7499 7482 5580 5561 6166 5713 7440 7425 7413 7410 7398 4459 7408 1263 6466 7386 6690 7356 1690 7313 1380 3986 7293 
1 28 1161 7799 2652 6006 5529 4341 7745 585 1479 6863 5833 7578 7567 6008 7537 7528 7513 5831 2573 7464 2852 7429 500 7392 2513 1146 7355 340 
1 5 6863 5501 1966 6773 7724 
1 2 6863 7588 
1 29 6863 7593 6348 2188 4708 5134 7647 2610 7626 862 6770 7642 1507 4752 4854 2530 3471 4756 7682 6285 692 7656 2219 7707 344 4190 3478 6104 1277 
1 14 6863 6423 1924 7685 7672 4165 2362 7709 6503 7678 5706 1167 7643 862 
1 10 7767 7787 7800 7814 7870 7885 47 2675 2845 1399 
1 6 7885 7870 6132 6549 7836 6119 
1 62 7885 7870 6132 7817 7789 7765 4683 6257 1167 7643 862 6770 7642 6175 5302 7560 5135 6597 7506 7487 7475 4402 2806 7435 3231 7410 7398 7391 7381 934 4198 7339 7333 7318 2708 7289 2184 7269 2985 3713 3256 3990 1862 7212 4703 4382 2516 5577 3413 4150 7246 7241 7228 7238 7235 6642 1663 5523 7277 7290 4902 4355 
1 8 6006 7771 7729 4165 7672 7651 2188 7597 
1 4 6863 7593 6612 7571 
1 21 7642 6275 7689 3104 6410 4343 4980 7778 1481 7764 4687 4090 7816 7820 4092 3656 7744 5593 3478 6104 1277 
1 8 7885 1834 5645 6004 7984 8002 6090 8076 
1 4 7885 1834 1196 7921 
1 13 7885 1834 5645 7953 7963 3372 3330 3750 4820 8034 8063 8080 1470 
1 15 3117 5258 6176 1470 8097 8072 5655 2731 7988 7925 5860 1980 5586 7834 4090 
1 4 8063 8023 8040 8057 
1 5 8057 8102 8083 8099 6176 
1 51 8072 8055 8039 8075 5407 8130 8115 1526 8089 8079 1400 4904 8183 8166 8175 6229 8152 8139 8101 5756 8054 2654 1384 7919 1190 7934 7956 2294 7987 5849 8041 1504 8032 7983 314 861 7916 3178 4470 7842 6271 7803 3955 6608 4876 7796 7807 2505 6917 7869 2607 
1 10 1277 5280 7804 1300 7833 2765 6376 7884 4898 7919 
1 38 7408 4459 7398 7410 3231 4166 1359 1498 7434 2449 4544 7446 7443 7450 7463 5473 7497 4597 4654 5187 5957 4211 2342 7582 3751 7605 7615 7630 7640 5065 332 7696 7713 4722 3923 5370 3445 7840 
1 10 2133 4748 4571 6789 2663 3923 1739 489 6476 1889 
1 6 332 6669 1889 5220 6000 7763 
1 4 7630 6471 7708 1889 
1 4 1739 3543 6669 6471 
1 4 4597 5100 1938 4544 
1 8 4211 7518 3621 6864 5473 1228 10 7446 
1 5 7593 7612 2276 6743 7685 
1 6 8079 1404 8071 5150 8166 8175 
1 10 8166 654 8060 7997 3132 4298 7949 5619 4898 7919 
1 14 8183 5924 8260 8249 8309 8319 6810 5459 3902 8329 8296 5711 6732 8175 
1 10 8249 563 8258 5496 5482 787 8301 8334 3532 6540 
1 4 8246 8271 6809 787 
1 6 1470 2115 8154 2111 8218 787 
1 6 5482 2070 6893 6459 4584 8072 
1 4 654 8060 6438 5756 
1 5 8054 119 5456 8020 7987 
1 5 5482 3385 6121 4282 3879 
1 40 7630 6756 798 6071 4367 7516 5270 2163 6862 2057 7401 1935 602 1763 7326 6361 699 2614 6505 2143 7214 3926 2555 7177 1145 7187 3892 1640 1491 5191 1926 1875 514 40 3110 366 1207 3510 126 1239 
2 15 338 1144 4235 349 4430 478 1863 1871 209 7303 900 226 4028 357 892 
1 36 7630 6756 6450 6353 1329 7516 5270 3054 4247 6862 4237 2693 5421 2752 5359 182 2000 7315 3388 6721 2809 7308 7285 7282 3205 2760 3003 5980 230 7323 4574 518 2777 336 1505 3110 
1 8 4734 5261 4350 3288 8634 8668 218 8671 
1 4 8668 8684 8724 1298 
1 4 6468 8551 8557 8570 
1 3 4239 1958 4282 
1 7 8161 5433 6226 5836 8077 8068 6188 
1 18 5482 4932 8324 4633 1021 6265 4469 8515 4706 6843 3153 6624 1457 8690 3975 5358 8752 3693 
1 5 6540 6029 8365 4370 6777 
1 11 8168 5366 5850 8272 6106 5976 8366 8381 8398 8454 8479 
1 4 8366 5420 6877 4200 
1 6 6106 8313 8344 8369 8413 8437 
1 3 5850 8272 6294 
1 3 5850 8272 8261 
1 3 8246 8340 8365 
1 3 5836 2491 8209 
1 4 3330 4308 8030 8057 
1 7 7849 625 4035 6157 4342 830 5706 
1 3 1167 7658 7642 
1 15 3471 7641 4488 3435 7562 7544 7525 6617 7502 7477 6301 398 5138 7428 3231 
1 5 4854 4657 5329 3921 4954 
1 2 4657 7574 
1 3 3471 7616 3435 
1 14 6376 2712 2727 6298 6160 7946 7959 7992 823 1612 7941 6415 8011 2731 
1 6 4092 5604 4905 4994 7920 7941 
1 6 6298 7876 6420 4642 5604 4092 
1 3 1277 7722 4445 
1 7 4445 748 7670 6302 7663 7677 7707 
1 4 5523 7236 5281 3538 
1 10 7228 7241 1752 2213 2366 7294 5508 2422 5330 340 
1 11 1146 7362 2383 6164 247 3355 7378 7389 3640 5710 934 
1 5 7293 7289 7309 6781 5170 
1 6 7293 6296 5932 7234 4818 720 
1 6 3256 5009 4008 279 5312 3745 
1 7 720 4818 1275 6368 261 4432 7313 
1 9 4666 319 2229 5169 130 7031 248 6723 3004 
1 13 702 187 2238 6567 174 3004 25 1585 471 784 1378 4666 319 
1 6 6466 6626 3313 3904 4575 134 
1 13 7356 5732 5498 599 408 5145 892 6831 70 7221 3473 7225 1783 
1 7 1871 7336 3292 802 1668 4401 4247 
1 6 4237 6817 3384 3241 302 6816 
1 13 6816 2560 5116 1386 7315 1415 3395 6505 2910 7232 3362 7279 478 
1 8 2851 7493 7478 1826 3101 7397 154 3640 
1 7 7567 6776 5863 6362 7492 3080 7478 
1 5 2573 6511 6557 7460 1826 
1 7 2383 1077 7301 3763 5590 4138 4703 
1 9 8032 3481 6460 8150 5334 5922 8323 8328 8452 
1 6 8020 4817 1649 2310 8069 3481 
1 13 8457 8431 5864 6896 3379 8293 8266 4758 8197 6026 8103 8062 314 
1 10 8457 5759 833 4952 6086 3550 2834 3741 632 8452 
1 8 2834 8522 8524 5639 6461 2347 8486 8517 
1 5 8524 5636 8552 5328 8565 
1 5 3902 8406 4243 4587 8476 
1 10 3902 8393 1847 6748 3326 4232 8198 6118 5989 8054 
1 7 8323 2314 873 8373 3872 2257 6896 
1 11 8328 8300 8312 3031 2740 8247 8227 8180 4107 1901 8054 
1 8 6229 8181 8198 8165 4455 4107 8088 5456 
1 6 2647 2937 1534 4875 5772 6624 
1 11 2647 8664 6907 129 4978 1089 2630 5944 8426 2088 4239 
1 2 6468 4978 
1 2 8671 8650 
1 5 3127 6451 3099 4240 2647 
1 2 2647 2493 
1 4 8671 8691 8702 5303 
1 14 3178 2716 6189 5703 7915 5816 7924 5089 31 7943 3548 7955 843 8013 
1 2 2607 7915 
1 4 2607 6802 428 5089 
1 6 2607 6802 7860 7839 3584 3344 
1 4 314 7973 36 5703 
1 3 2505 5393 4015 
1 7 4015 5277 7692 5011 6123 826 7545 
1 6 7692 6719 879 6087 7587 7559 
1 6 3344 3584 7781 4451 7712 2150 
1 2 7712 3146 
1 16 6917 5114 1041 7785 597 7743 7718 6035 7645 7629 643 7594 7573 7554 1963 7515 
1 2 7629 1720 
1 6 3344 7865 2966 7852 5289 4589 
1 5 3344 7865 7898 389 7943 
1 5 7852 6912 5581 843 8013 
1 15 7986 8029 4410 8046 8049 8053 6464 3865 8096 8073 4685 4878 8022 3378 6500 
1 4 7943 7970 308 8029 
1 5 7973 3193 8036 8043 8016 
1 10 314 8066 5076 8074 8087 8059 8091 8116 8090 4410 
1 10 1117 4822 755 7484 7467 3423 4264 3317 5516 6181 
1 5 3317 1377 6913 2840 4779 
1 4 5516 6801 2968 4073 
1 2 7467 7474 
1 4 6853 8819 6915 6310 
1 5 6310 2545 765 8755 8724 
1 4 6310 58 4547 5718 
1 2 6310 2601 
1 6 2601 5789 8916 6292 8954 1618 
1 7 5789 4959 6768 3084 5728 5035 6853 
1 3 6853 5121 8768 
1 3 6853 6726 1127 
1 3 1127 8786 8768 
1 9 1127 6350 8818 5001 5606 4811 8848 8827 3424 
1 13 5221 6631 9068 9076 6436 4193 8995 9032 2221 9020 1292 9013 5151 
1 5 796 9059 4788 9013 5151 
1 4 796 6289 9024 5151 
1 6 5151 5093 8934 4113 8891 4811 
1 7 5606 5003 2308 4724 6680 5772 6624 
1 11 8752 8778 5126 1820 4020 4849 8924 8943 6234 8944 6475 
1 5 1292 5858 8918 979 4811 
1 8 5858 6284 5518 447 6920 6382 4649 6853 
1 4 6920 5743 8949 4193 
1 5 447 6560 8867 1116 5606 
1 4 5606 6497 6225 8918 
1 4 5151 6821 5085 8905 
1 3 8848 3613 4084 
1 8 6821 4307 3501 8998 6475 569 8921 4849 
1 3 6310 6768 3084 
1 5 8949 5743 6286 8882 5728 
1 5 2727 5301 4124 7822 4642 
1 3 5280 7794 4124 
1 6 830 7697 6257 4456 7680 7642 
1 5 6549 761 7786 5490 4456 
1 5 7764 5568 797 7688 4854 
1 5 7764 5969 552 4756 3471 
1 2 4090 7788 
1 6 7816 5804 3637 5493 6835 692 
1 6 5860 1980 7903 6038 3689 7816 
1 7 1481 6331 7835 7863 1710 6622 6119 
1 3 6773 6117 2918 
1 2 6773 4863 
1 4 7537 4315 4029 4554 
1 9 862 7626 7600 6581 7565 5736 2991 6236 5561 
1 3 5135 6597 6236 
1 4 5302 6055 5610 1566 
1 4 6617 5857 7548 307 
1 4 7646 692 7656 2219 
1 5 6104 2500 3927 7798 4642 
1 5 4015 6686 7748 754 7654 
1 4 754 4422 7719 6710 
1 2 7748 7769 
1 4 4015 7762 7737 5277 
1 5 8116 5338 2274 155 8087 
1 4 4685 2917 6093 6500 
1 10 6720 2917 757 6093 8048 8021 4763 1953 7957 5673 
1 2 6500 7957 
1 2 5673 3378 
1 2 6093 8022 
1 2 2917 4878 
1 3 757 6720 4685 
1 3 757 8095 8048 
1 2 6500 4763 
1 2 6093 8021 
1 8 5673 4500 7901 5072 2087 6418 5933 4636 
1 7 2087 6418 6558 7791 6155 1156 7698 
1 6 7845 7828 7847 2354 7871 2087 
1 8 7845 1653 6705 3198 5527 565 7878 7899 
1 6 2274 2445 6252 3614 8137 3865 
1 4 8307 8275 4662 2124 
1 9 8307 8255 3946 3222 8244 8215 6428 8136 6720 
1 7 5117 5241 506 6513 3147 3126 2274 
1 6 8307 8288 4880 8264 3147 6513 
1 4 5117 8368 6042 8307 
1 4 2445 8202 159 8221 
1 2 8275 5386 
1 3 8059 5914 8029 
1 3 8043 5463 2691 
1 2 7986 2154 
1 8 5117 8417 5231 5278 4853 8447 8488 5759 
1 10 5117 6580 5231 8481 5635 4214 6393 173 1907 492 
1 10 5278 742 4214 4387 6268 2911 8625 8640 6216 5012 
1 6 8323 8268 5010 8123 8092 8062 
1 7 8266 5993 8268 5922 8252 8211 388 
1 10 8197 8186 6187 8203 5010 8150 8151 388 8070 4817 
1 7 3741 6519 8443 8422 8396 1321 6896 
1 6 6513 6017 296 8361 8332 8293 
1 5 8197 1150 8216 6253 2274 
1 2 8103 5076 
1 5 8103 4309 8123 874 6460 
1 10 2347 4967 3707 4602 6685 8333 3832 8269 8236 8165 
1 4 8165 4455 8189 8227 
1 7 8151 3989 8211 3467 8169 2164 4107 
1 2 2164 8088 
1 8 6748 1087 8415 3662 5558 8486 8530 8552 
1 4 5328 4623 8620 5579 
1 4 4623 4982 8628 6579 
1 8 1269 6916 8607 5807 6162 4908 5759 8457 
1 7 1269 4731 2956 8603 8577 6599 5759 
1 6 492 2139 3311 8665 4731 1269 
1 11 1269 3452 832 6419 8698 8712 8739 8719 3862 8675 5579 
1 9 1269 5866 8726 1951 151 1605 4998 4794 6687 
1 5 8726 8711 8700 5746 8665 
1 15 492 8678 5259 8692 8710 707 2581 4227 1614 5949 8793 5349 8833 8857 6673 
1 5 5012 5082 3236 2741 5349 
1 10 3236 1793 8729 6259 8703 8689 3197 4471 8678 492 
1 9 6673 8864 4324 8858 4306 8811 5648 2263 707 
1 5 4549 8923 6521 6208 4306 
1 6 4549 6584 8915 5056 8885 6673 
1 4 5349 8817 5983 8847 
1 6 6162 1502 8545 775 8580 8552 
1 6 6916 8618 6413 3498 8578 8545 
1 4 8580 5252 4236 3862 
1 6 1601 8462 2040 8416 2821 5117 
1 6 1601 4319 8544 1267 8606 5012 
1 6 4319 4655 5105 8625 8646 8670 
1 8 5082 8659 8646 8638 1552 8643 8644 1907 
1 2 742 2166 
1 7 492 8627 4042 8584 6709 8577 6599 
1 7 5117 6812 6641 6649 8376 1813 5864 
1 5 1601 8434 2381 8363 4249 
1 12 6580 8464 1047 2107 8514 5963 4319 6715 8521 2420 8525 4398 
1 3 7713 568 66 
1 6 7615 7591 3044 7546 5029 6598 
1 2 7450 3627 
1 3 4401 6205 179 
1 4 2693 7401 1668 4401 
1 5 3178 5426 4960 1976 6917 
1 2 5426 3895 
1 5 2716 7902 5282 7894 2607 
1 5 861 7938 2716 7887 4960 
1 2 5114 3120 
1 2 597 5869 
1 4 7762 5387 7756 7743 
1 5 5860 7925 4027 7967 3750 
1 5 6622 7872 7892 5597 7921 
1 4 5728 2301 377 3549 
1 4 8995 8973 8957 5858 
1 2 8949 5909 
1 5 5085 8910 8925 3487 569 
1 6 6234 9012 1616 6263 4689 5616 
1 15 3214 6741 9274 9248 9230 6345 9149 6066 9075 4332 3680 8974 292 6366 6687 
1 5 6366 8917 2174 156 1605 
1 8 292 5068 1253 5439 5039 8792 8772 8726 
1 10 8974 4747 8946 6654 5898 4406 4472 6520 8732 8700 
1 9 4549 8976 1837 3571 9105 4744 925 1362 9075 
1 4 8976 6746 6344 5622 
1 3 3571 9041 9009 
1 6 6687 8877 5075 8807 6554 151 
1 2 151 909 
1 6 6366 3493 1402 2232 9073 6066 
1 7 1837 9083 9127 9148 9180 9204 3592 
1 10 4549 5672 5687 5998 9102 3874 9155 9189 3062 9218 
1 5 3592 9225 1208 5716 9218 
1 7 9204 3794 3171 9184 9182 6716 925 
1 2 6716 6066 
1 9 9188 4877 9112 5846 4384 8985 8939 4230 8847 
1 13 4230 286 8809 8789 4965 8744 6120 1349 8677 8663 4364 252 4533 
1 9 9188 4877 9139 9089 9093 2884 3320 490 4857 
1 8 9114 9094 2884 9028 8994 5146 8942 4230 
1 4 2884 9058 4749 5659 
1 2 4364 6247 
1 3 4533 8601 1825 
1 3 252 6577 8601 
1 6 4364 8594 1796 1126 8474 1482 
1 5 4045 9080 5499 9048 8998 
1 3 6234 6231 3186 
1 5 4045 9122 6199 9157 9211 
1 4 4380 4563 3071 9157 
1 5 4045 9118 9142 9170 9158 
1 6 4045 5786 9096 9067 9049 796 
1 2 4307 796 
1 2 4788 5626 
1 4 9157 9106 3756 9059 
1 4 4380 2591 9123 3756 
1 2 9123 4788 
1 8 4380 3920 9181 4151 9133 2346 2364 2221 
1 8 4380 6481 9246 9260 3337 3035 1143 6905 
1 16 2364 4550 9134 4286 1779 735 9264 9298 6905 3008 5800 5448 4031 9421 6811 1433 
1 3 1779 1229 9133 
1 8 6481 9206 6727 1555 9212 2576 9264 685 
1 6 4550 9064 593 3291 1044 9226 
1 4 4031 5242 3229 6387 
1 7 3229 9282 4447 9234 2272 3052 4380 
1 6 9246 2212 1460 6141 9358 5448 
1 6 4447 6906 9244 5774 9190 9170 
1 7 3214 1289 9231 9207 5935 24 9158 
1 8 9073 9098 5397 3398 3331 5385 4883 9274 
1 6 6741 9304 9252 9223 4110 5774 
1 4 9223 9210 3966 9207 
1 3 9252 2190 9231 
1 4 5774 5829 9219 6199 
1 4 4563 6620 9106 9096 
1 2 4045 6096 
1 2 1616 9045 
1 9 1433 6194 5392 6655 6283 5242 6141 2212 3052 
1 4 6655 9384 3808 6387 
1 6 3808 9354 6508 9326 2603 6387 
1 6 9326 9320 2355 9304 9278 3214 
1 16 6741 9350 6526 4371 9454 9468 6688 4579 5567 9511 9499 6576 9515 9529 9512 1433 
1 5 3738 9478 9462 9450 4371 
1 5 6741 9296 6421 3992 6846 
1 10 9274 9295 9312 3757 4700 9337 3681 2271 9353 9370 
1 10 6526 9380 6421 9357 4700 6813 6291 6788 4566 6345 
1 2 6788 9230 
1 9 6066 9153 2974 9228 9258 6305 2055 9340 9353 
1 6 9370 9347 3578 9287 9247 3592 
1 4 4110 4499 4830 24 
1 5 6688 3825 9405 4914 9320 
1 8 9468 4732 9410 6339 4212 9341 6504 6741 
1 4 3825 5840 6644 1870 
1 5 5840 1909 6689 1405 5392 
1 12 9511 3271 5453 4922 4139 5947 9592 6578 5131 5283 9599 4245 
1 4 1333 9605 4439 9529 
1 33 9605 9630 9636 4229 4485 2723 3479 9753 842 9802 9839 5362 9867 2764 9880 3602 9912 4002 9955 2748 3769 10004 10000 3658 10015 10022 2453 10032 10038 311 4295 10052 6782 
1 4 9636 9607 3474 9515 
1 9 4229 9642 3093 9617 3396 9602 4551 9596 4139 
1 6 4139 3803 6193 9535 1659 3738 
1 11 3396 5646 2080 3891 6571 9664 942 9649 3654 6793 6449 
1 6 5947 9621 2080 9677 9728 4711 
1 3 9621 828 6578 
1 3 9592 6392 9535 
1 4 3738 5967 2361 9550 
1 29 3479 4821 2458 6338 9773 3880 9762 2768 9736 5380 4365 9728 9722 9755 1250 9730 9732 306 2050 9744 9729 1050 5488 5549 580 6501 9697 9675 5682 
1 17 4485 6039 2458 6771 9801 1845 9860 5024 5707 6430 5889 1547 9956 9966 9963 6589 9976 
1 6 1250 4746 5462 9692 9670 9649 
1 7 1139 2955 9732 4390 5287 4736 6449 
1 14 84 10138 3733 4999 10139 1946 10154 10149 4078 10145 379 5999 3128 10159 
1 7 6338 9789 262 1045 9847 2051 6047 
1 2 9789 9800 
1 4 9956 9947 9939 4992 
1 13 9956 9952 9949 9950 5485 9934 9918 9913 9877 687 9861 9841 1845 
1 4 2368 9903 9913 9907 
1 2 9880 9888 
1 6 9956 6791 9977 2006 1582 5057 
1 14 6791 9967 1680 3685 839 3206 9998 5570 10019 6695 5148 6531 10034 10041 
1 2 311 575 
1 2 10052 4525 
1 3 1680 9950 3977 
1 11 5485 9961 3202 9990 6890 2172 5458 10020 2726 10012 10004 
1 5 9990 6836 5314 10004 3658 
1 17 5447 9743 9720 5253 2772 9660 9638 9631 5685 317 9474 9448 9430 1888 9403 576 9370 
1 8 9370 9416 2518 9510 6494 5685 9558 3791 
1 4 9510 5372 3165 9550 
1 8 9550 1451 9480 4805 9425 5624 9397 9370 
1 8 9416 3717 5624 9376 3681 5477 6305 9266 
1 12 9430 9413 9437 4743 4136 1589 6293 4188 5115 5443 5053 9370 
1 7 9430 9453 1202 9509 3791 9544 5747 
1 5 2080 9674 9691 4498 2768 
1 5 9674 6321 5574 6424 4485 
1 5 6449 4245 2660 5528 9550 
1 11 9550 3228 9626 943 9673 9685 1282 9697 9700 3697 9743 
1 4 9697 6 5320 9631 
1 4 5967 2265 6610 4805 
1 7 5624 5633 9383 9371 1940 9434 6846 
1 5 5115 4632 9272 1766 9218 
1 11 3111 6744 3889 8922 8926 2672 2319 3039 1132 543 4487 
1 10 4487 8669 2742 2237 4971 3154 4580 8427 8412 8390 
1 9 8390 8367 4913 8279 2020 5337 2759 6849 5925 
1 4 2020 8280 3377 8286 
1 4 5925 8239 8267 8286 
1 16 8286 6447 8351 1204 8399 5326 8449 1804 5381 3844 941 8609 8635 4021 6148 8749 
1 9 5925 1902 6144 4131 7978 7942 2627 2365 5376 
1 4 5376 6251 705 4351 
1 6 5925 8121 8112 8122 4192 4616 
1 3 3111 8999 3069 
1 6 3069 9054 2404 9125 9144 5208 
1 5 3069 4219 9016 4955 806 
1 6 3111 4834 8988 9000 8991 806 
1 10 806 8962 5412 1708 1672 8912 5026 8899 8884 277 
1 10 806 9001 954 9071 9050 991 1620 210 1031 745 
1 6 4351 4702 7490 1102 2559 7445 
1 5 7445 3342 6177 7409 6156 
1 4 6156 7363 1960 7341 
1 2 4616 3984 
1 15 3984 8098 60 4143 1340 7877 2643 5607 424 714 5454 4046 5791 123 8009 
