5 97 4578 1161 5664 7849 3883 7885 1834 5645 6004 7995 6188 8030 8057 8084 4075 8168 8199 3117 6180 6638 8246 3919 6029 6540 4239 8429 5934 3962 2331 8543 6468 4734 3127 6381 5572 6224 1298 1136 4299 8819 6853 4649 3405 6286 5743 8949 4193 8995 9032 2364 2346 9133 4151 9191 1555 9237 9298 1143 6905 3008 5800 4667 9421 6811 1433 9512 9529 4439 5247 9607 9636 4229 4485 2723 3479 9753 842 9802 9839 5362 9867 9880 3602 9912 4002 9955 2748 3769 10004 3658 10015 5244 10022 10032 10038 311 4295 
5 32 4578 7749 6931 2362 7667 4708 6778 7597 6867 3067 4945 2851 7499 7482 5580 5561 6166 5713 7440 7425 7413 7410 7398 4459 7408 1263 6466 7386 6690 7356 1690 7313 
5 28 1161 7799 2652 6006 5529 4341 7745 585 1479 6863 5833 7578 7567 6008 7537 7528 7513 5831 2573 7464 2852 7429 500 7392 2513 1146 7355 340 
5 4 6863 5501 1966 6773 
5 2 6863 7588 
5 29 6863 7593 6348 2188 4708 5134 7647 2610 7626 862 6770 7642 1507 4752 4854 2530 3471 4756 7682 6285 692 7656 2219 7707 344 4190 3478 6104 1277 
5 14 6863 6423 1924 7685 7672 4165 2362 7709 6503 7678 5706 1167 7643 862 
5 10 7767 7787 7800 7814 7870 7885 47 2675 2845 1399 
5 6 7885 7870 6132 6549 7836 6119 
5 62 7885 7870 6132 7817 7789 7765 4683 6257 1167 7643 862 6770 7642 6175 5302 7560 5135 6597 7506 7487 7475 4402 2806 7435 3231 7410 7398 7391 7381 934 4198 7339 7333 7318 2708 7289 2184 7269 2985 3713 3256 3990 1862 7212 4703 4382 2516 5577 3413 4150 7246 7241 7228 7238 7235 6642 1663 5523 7277 7290 4902 4355 
5 8 6006 7771 7729 4165 7672 7651 2188 7597 
5 4 6863 7593 6612 7571 
5 21 7642 6275 7689 3104 6410 4343 4980 7778 1481 7764 4687 4090 7816 7820 4092 3656 7744 5593 3478 6104 1277 
5 7 7885 1834 5645 6004 7984 8002 6090 
5 4 7885 1834 1196 7921 
5 6 8057 8077 5836 6226 5433 8161 
5 13 7885 1834 5645 7953 7963 3372 3330 3750 4820 8034 8063 8080 1470 
5 15 3117 5258 6176 1470 8097 8072 5655 2731 7988 7925 5860 1980 5586 7834 4090 
5 4 8057 8040 8023 8063 
5 5 8057 8102 8083 8099 6176 
5 5 2731 8011 6415 7941 1612 
5 38 8072 8055 8039 8075 5407 8130 8115 1526 8089 8079 1400 4904 8183 8166 8175 6229 8152 8139 8101 5756 8054 2654 1384 7919 1190 7934 7956 2294 7987 5849 8041 1504 8032 7983 314 861 7916 3178 
5 10 1277 5280 7804 1300 7833 2765 6376 7884 4898 7919 
5 37 3445 5370 3923 4722 7713 7696 332 5065 7640 7630 7615 7605 3751 7582 2342 4211 5957 5187 4654 4597 7497 5473 7463 7450 7443 7446 4544 2449 7434 1498 1359 4166 3231 7410 7398 4459 7408 
5 10 2133 4748 4571 6789 2663 3923 1739 489 6476 1889 
5 5 332 6669 1889 5220 6000 
5 4 7630 6471 7708 1889 
5 4 1739 3543 6669 6471 
5 4 4597 5100 1938 4544 
5 8 4211 7518 3621 6864 5473 1228 10 7446 
5 5 7593 7612 2276 6743 7685 
5 3 7293 3986 1380 
5 6 8079 1404 8071 5150 8166 8175 
5 10 8166 654 8060 7997 3132 4298 7949 5619 4898 7919 
5 9 8183 5924 8260 8249 8309 8319 6810 5459 3902 
5 10 8249 563 8258 5496 5482 787 8301 8334 3532 6540 
5 4 8246 8271 6809 787 
5 6 1470 2115 8154 2111 8218 787 
5 6 5482 2070 6893 6459 4584 8072 
5 4 654 8060 6438 5756 
5 5 8054 119 5456 8020 7987 
5 5 5482 3385 6121 4282 3879 
5 40 7630 6756 798 6071 4367 7516 5270 2163 6862 2057 7401 1935 602 1763 7326 6361 699 2614 6505 2143 7214 3926 2555 7177 1145 7187 3892 1640 1491 5191 1926 1875 514 40 3110 366 1207 3510 126 1239 
5 6 338 1144 4235 349 4430 478 
5 36 7630 6756 6450 6353 1329 7516 5270 3054 4247 6862 4237 2693 5421 2752 5359 182 2000 7315 3388 6721 2809 7308 7285 7282 3205 2760 3003 5980 230 7323 4574 518 2777 336 1505 3110 
5 8 4734 5261 4350 3288 8634 8668 218 8671 
5 4 8668 8684 8724 1298 
5 4 8570 8557 8551 6468 
5 3 4239 1958 4282 
